222222222222222222222222222222222222222222222222222222222222
211111111111111111111111111111111111111111111111111111111112
210000000000000000000000000000000000000000000000000000000012
210000000000000000000000000000000000000000000000000000000012
210000000000000000000000000000000000000000000000000000000012
210000000000000000000000000000000000000000000000000000000012
210000000000000000000000000000000000000000000000000000000012
210000000000000000000000000000000000000000000000000000000012
210000000000000000000000000000000000000000000000000000000012
210000000000000000000000000000000000000000000000000000000012
210000000000000000000000000000000000000000000000000000000012
210000000000000000000000000000000000000000000000000000000012
210000000000000000000000000000000000000000000000000000000012
210000000000000000000000000000000000000000000000000000000012
210000000000000000000000000000000000000000000000000000000012
210000000000000000000000000000000000000000000000000000000012
210000000000000000000000000000000000000000000000000000000012
210000000000000000000000000000000000000000000000000000000012
210000000000000000000000000000000000000000000000000000000012
210000000000000000000000000000000000000000000000000000000012
210000000000000000000000000000000000000000000000000000000012
210000000000000000000000000000000000000000000000000000000012
210000000000000000000000000000000000000000000000000000000012
210000000000000000000000000000000000000000000000000000000012
210000000000000000000000000000000000000000000000000000000012
210000000000000000000000000000000000000000000000000000000012
210000000000000000000000000000000000000000000000000000000012
211111111111111111111111111111111111111111111111111111111112
222222222222222222222222222222222222222222222222222222222222
