222222222222222222222
221111111111111111122
210000000000000000012
210000100000000000012
210001100000000000012
210000000000000000012
210000000000000000012
210000000000000000012
210000000000100000012
210000000000100000012
210000000000100000012
210000000000000000012
210000000000000000012
210000000000000000012
210000100000000000012
210000100000000000012
210000100000000000012
210000000000000000012
210000000000000000012
221111111111111111122
222222222222222222222
