222222222222222222222
221111111111111111122
210000000000000000012
210111110001111110012
210100010001000010012
210100010001000010012
210111110001111110012
210000000000000000012
211111111001111111112
210000001001000000012
210000001001000000012
211111111001111111112
210000000000000000012
210111111111111110012
210100000000000010012
210101111111110010012
210100000000000010012
210111111111111110012
210000000000000000012
221111111111111111122
222222222222222222222
